ЯблокиК	Мешок
ЯблокиЖ	Монета Золотая
ЯблокиЗ	Cucumber
Бананы	Меч 2
Виноград	Basil Leaf Violet
Морковь	Кубок Бронзовый
ЗаяцБ	Snow Weasel
ЗаяцС	Quokka
Жабы	Frog
Листы	Arugula Leaf A
Киви	Olive Green
Сэндвичи	Печенье Ёлка
Томаты	jam
Яичницы	Письмо
Сыр	Cheese
Батоны bread
КусочкиСэндвича	Mushroom Slice
КуриныеНожки	Мясо на кости
ШарикиК	Ёлочная игрушка  Красная
ШарикиЖ	Ёлочная игрушка  Жёлтая
ШарикиФ	Ёлочная игрушка  Фиолетовая
ШарикиС	Ёлочная игрушка Синяя
ШарикиЗ Ёлочная игрушка Зеленая
Апельсины	Шар Пинг-Понг
ЛуныЧ	Бомба 4
ШарыДляБоулинга	Шар Боулинговый
ПланетыСЗ	Шар Волейбольный
Утки	Pelican
УтятаЖ	Duck
Тыквы	Тыква Хэллоуин
Барабаны	Консервы
КусочкиАрбуза	Звезда Красная
Жирафы	Pronghorn
Мед	Свеча
КруглыеПчелы	Clownfish
ПчелыСБольшойГоловой	GilaMonster
Кофе	Череп
Круассаны	Печенье  Звезда
Торты	Cheesecake_Plain_Slice_01
ПончикиР	candy
ПончикЗ	candy.001
ПончикЖ	candy.002
ПончикСП	donut
ПончикСПР	donut.001
ПончикСПС	donut.002
ШоколадныеТортики	Cheesecake_Chocolate_Whole
Кексы	Cupcake_Chocolate
ПодаркиК	gift
ПодаркиЗ	gift.001
ПодаркиФСТ	gift.003
ПодаркиБР	gift.004
ПодаркиФ	gift.002
Лимоны	Колокольчик
Кубики	Игральный Кубик Серебряный
РозовыеГитары	Звезда на ёлоку фиолетовая
7	Snake
Чеснок	Подарок Без банта Фиолетовый
БанкиКвСЖ	Рождественский носок Синий
БанкиКрСФ	Рождественский носок Фиолетовый
БанкиКрК	Рождественский носок Красный
БанкиБ	Рождественский носок Жёлтый
Чайники	pot
СамолетыБК	snowman
СамолетыБЖ	snowman.002
СамолетыБЗ	snowman.001
СамолетыБФ	snowman.003
СамолетыБО	snowman.004
СамолетыБС	snowman.005
СамолетыО	snowman.006
СамолетыФ	snowman.008
СамолетыЖ	snowman.007
КристаллыК	Алмаз 1
КристаллыЖ	Алмаз 2
КристаллыФ	Алмаз 3
КристаллыС	Алмаз
КристаллыР	Алмаз 4
КристаллыЗ	Алмаз 5
Роботы	Тюбик Голубой
?	Cobra
!	Emu
КорзинкиР	basket
КорзинкиЗО	basket.001
КорзинкиБР	basket.002
КорзинкиЖС	basket.003
ДлинныйФрукт	Губная помада жидкая Красная
Горох	Омела 2
Вишня	Звезда на ёлоку красная
Трубы	Звезда на ёлоку жёлтая
Пианино	piano
Радио	Кинга Розовая
Микрофоны	Ключ Золотой 2
Звезды	Звезда 1
КнижкиМаленькиеЖО	book
КнижкиМаленькиеСЖ	Книга 3
КнижкиМаленькиеЖК	book.001
КарандашиЖ	pen
КарандашиР	pen.001
КарандашиФ	pen.002
НотыС	treble clef
НотыР	treble clef.001
НотыЖ	treble clef.002
Т	Bat
Планшеты	Щит 3
ПортфелиЗО	bag
ПортфелиЖК	bag.001
ПортфелиБК	bag.002
ПортфелиК	bag.003
ПортфелиФЗ	bag.004
МаркерыЖ	model_0.001
МаркерыЧ	model_0.002
МаркерыС	model_0.003
Столы	sofa
ТабуреткиСБ	chair.002
ТабуреткиОЗ	chair.001
ТабуреткиКЖ	chair
ТабуреткиЗФ	chair.003
БиноклиЖС	spyglass
БиноклиКЖ	spyglass.001
БиноклиБЖ	spyglass.002
БольшиеКнижки	notepad
ВоздушныеШары	kettlebell
Луны	Шар Гольф
Свиньи	Pig
ГоловыСвиней	Rabbit
ПодушкиК	box
ПодушкиЖ	box.001
ПодушкиФ	box.002
ПодушкиЗ	box.003
ПодушкиО	box.004
ПодушкиС	box.005
Браслеты	clock
Q	Onion Slice Green
X	Pepper Red Slice
E	Кубок
КонфетыК	bathbomb.002
КонфетыЗ	bathbomb.001
КонфетыФ	bathbomb.003
КонфетыС	bathbomb.004
КонфетыПолностьюКрасные	bathbomb.005
КонфетыЖК	bathbomb.006
Радуги	Звезда Красная с золотой окантовкой
Розы	Сердце
Королевы	Звезда Золотая
КатушкиНиток	barrel
Короны	Корона
Петухи	Rooster
C	Подкова Серебрянная
4	boomerang
ОсьминогиЗ	bug.003
ОсьминогиР	bug.002
ОсьминогиС	bug.004
ОсьминогиК	bug.001
БабочкиКС	БабочкиКС
БабочкиБС	БабочкиБС
БабочкиБР	БабочкиБР
БабочкиКР	БабочкиКР
БабочкиЖ	Бабочка Жёлтая
БабочкиК	Бабочка Красная
БожьиКоровки	GiftHeart 7
Слоны	Elephant
Коровы	Cow
Кони	Reindeer
КониЦ	Donkey
ГоловыКоней	Kangaroo
Йогурты	Бабочка Фиолетовая
Гамбургеры	Camel
Пиццы	Пицца
Хотдоги	Rattlesnake
Собаки	Dog
КрасныеПанды	RedPanda
Кошки	Cat
Рыбки	Carp
Кости	Свиток 3
Скрипки	Ключ Бронзовый
Бревна	Стакан с какао
Арфы	Armadillo
Колокола	Колокольчик 2
Желуди	Звезда Бронза
Метлы	Стрелы
КубикиЛьда	Ёлка Маленькая Снежная
Телефоны	Swan
Киты	Orca
Иглу	Polar Bear
ТуалетнаяБумага	Snow Owl
Орлы	Eagle
РакиЖ	lobster.001
РакиЗ	lobster.002
РакиК	lobster
J	Chick
МороженныеЖ	Замок 2 Золотой
МороженныеКЗ	lock
МороженныеФБ	lock.001
МороженныеДлинные	lock.002
Веера	Ключ Золотой
Блокноты	Весы
Тако	Pineapple Slice
Деревья	Ёлка Большая Зелёная
7	Пробирка 1
Тигры	Tiger
Бегемоты	Hippo
Совы	Owl
Лисы	Fox
БелыеЛисы	Arctic Fox
Акулы	Dolphin
МашиныК	car.002
МашиныЖ	Italian_Bull_Yellow
МашиныЗ	Italian_Bull_Green
МашиныФ	car
МашиныС	car.001
МашиныР	Italian_Bull_Pink
ОвцыБ	Sheep
ОвцыР	Hen
Носороги	Rhino
Панды	Panda
БаскетбольныеМячи	Шар Баскетбольный
ЯйцаКуриные	Яйцо
ЯйцаСТО	Фейерверк Фиолетовый
ЯйцаСТЗ	Фейерверк Зелёный
ЯйцаСТС	Фейерверк Синий
ЯйцаСТК	Фейерверк Красный
КружкиСКК	Кружка с какао Красная
КружкиСКЗ	Кружка с какао зеленая
КружкиСЧаем	Кружка с какао белая
КружкиСКР	Кружка с какао розовая
Грибы	Гриб 3
Стрекозы	Kookaburra
Шляпы	Песочные Часы Бронзовые
Муравьи	Platypus
Призраки	Ёлка Большая Снежная
ЛетающиеТарелки	plate
ФутбольныеМячи	Шар Футбольный
Газеты	Газета
Лодки	model_5
Мухи	Леденец  Красно-Зелёный
2	Колокольчик
СпасательныеКругиР	Леденец Красный
СпасательныеКругиЗ	Леденец Зелёный
СпасательныеКругиС	Леденец Синий
ЕжиМорские	Стакан с розовой жидкостью
ЛеденцыБЖ	Леденец на палочке желтый
ЛеденцыР	Леденец на палочке розовый
ЛеденцыФЗ	Леденец на палочке фиолетовый-зеленый
Пилы	Секундомер с цифрами
0	Duck
Шестеренки	Шестерёнка
Вилки	Avocado Slice B
Ложки	Avocado Slice A
9	Onion Slice
Обезьяны	Gorilla
Пауки	Olive Black
Зебры	Zebra
Облака	Кубок Серебрянный
P	Омела 3
M	Ham Slice B
W	Тушь для ресниц
Пушки	Мясо Стейк
Крокодилы	Crocodile
8	Crow
Осьминоги(реалистичные)	Squid
Нарвалы	TasmanianDevil
Изолента	Корона Серебряная
B	SeaHorse
Ведра	Пробирка
Синтезаторы	Щит 2
Ксилофоны	Tomato Slice Yellow
КартофельФри	Tomato Slice Red
КоробкиОтФри	Зеркальце
Фри	Fri Fries
1	Parrot
5	Buffalo
3	Золотой Слиток
6	Koala
A	Kingfisher
N	SeaOtter
U	Sloth
R	Камушек (хз что это))
Бочки	Динамит
Громкоговорители	Громкоговоритель
ШлемыСкафандра	Шлем
Ракеты	rocket
РакетыЖ	rocket.001
БольшиеПланеты	Бутылка с окантовкой
L	Hog
O	Метка
V	Manatee
Y	Possum
G	Duck
Самолеты-кукурузники	Магнит
ПолосатыеШарыБС	Яйцо Пасхальное 2
ПолосатыеШарыКБ	Гриб 2
ПтицыДлинныеС	Polypropylene duster
ПтицыДлинныеК	Polypropylene duster.001
ПтицыДлинныеЗ	Polypropylene duster.002
ПтицыМелкие	Ox
ШарыПляжные	Снеговик с шарфом
Кружки	Стакан с водой
Динозавры	rock
ФлаконыК	Духи Розовые
ФлаконыС	Духи Синие
ПеченьеОвсяное	Печенье Круглое
H	Бомба
Зонты	Лук
Поезда	wagon
Леопарды	Cheetah
ГоловыДинозавров	Sea Lion
Роллики	Dove
Z	Ostrich
Сатурны	Компас
Кактусы	Леденец новогодний  Зелёный
Бекон	Bacon Slice Medium
Отвертки	Лопата
ОтверткиБ	shovel
ОтверткиО	shovel.001
ОтверткиФ	shovel.002
Колеса	Гайка
Скутеры	Flamingo
Болты	Шуруп
ЧастиЖелудя	Walrus
Мыши	Mouse
Волки	Wolf
Канистры	Arowana
ПазлыФ	Рождественский носок Фиолетовый
ПазлыС	Щит 4
Ножницы	Ожерелье
Танки	Звезда Зелёная
РазноцветныеМячи	Часы
Цилиндры	Ракета
F	Snake
ШляпыБолельщика	Венок
ПряничныеЧеловечки	Печенье Человек
Бубны	Гриб
Батарейки	Батарейка 2
Лупы	Бутылка с ценником
Корм	Подарок Без банта Жёлтый
Окна	Щит
Молоты	Кирка
Молотки	Молоток
Бластеры	Замок
ГоловаОвцы	Tapir
Насадки	Керосиновая Лампа
СтолыСоСкатертью	sofa.001
ПирогБольшой	Cheesecake_Chocolate_Whole
ПирогМаленький	Cheesecake_Mini_Chocolate
Марки	Письмо
Мониторы	Свиток
Кроссовки	shoes
Помада	Губная помада Красная
КубикиВопрос	Cube.002
СдвоенныеНоты	bass clef
БанкиГазировкиК	battery.002
БанкиГазировкиЖ	battery
БанкиГазировкиЗ	battery.003
БанкиГазировкиС	Батарейка 1
БанкиГазировкиФ	battery.001
Булки	Burger Bread I
ПирожныеР	Premium_Raspberry_Whole
Велосипеды	scuter
ЗаросшиеПеньки	Стакан с какао 1
Лук	onion
Лампы	light
Блины	pancakes
СамолетикиБумажные	origami
ГаечныйКлюч	wrench
ЗаячьиУшки	cat ears
Черепахи	Tortoise
S	Звезда на ёлку Синяя
D	Баночка Фиолетовая